111111111111111111111111111111111111111111
101110000110110100000001111001000000001011
110001011011100000010001000000010101110001
100000000110001101001000111010100100100101
1100101100100100000001C0110011011000010011
110001000111110111010001111101111100011101
1000010000101000C1011001000000101001000111
101000100111000101000010000000000000001101
111011001100010000000000010000000000010011
10111101101000E110000000100010001001110011
100001010001000000001001100000010100010001
111011011000P11100010000011011010100CC1001
111100111000010101010C10100000010001001101
100101000100100000011010110001110011001011
100001010000100001010000101000011000101011
110011010010100011010110101110001011110001
111111111111111111111111111111111111111111
