11111111111111111111
100011000110001C1101
11101011111100111011
11010101100110101111
10010010111101100111
10011001001101111111
10111001110000000111
10010001101011100101
11111010011010101111
10111111100100101101
11110010101111110001
11101100011011000111
10111110101110001111
11010100P10110110011
11011000001011100101
10001111100010010111
11100110100001000011
10000001011000000011
10101111111000001101
10010000001000001111
1001110101101101E011
10001100100001101011
11101010100111111001
10111011110011010011
11110000010011110001
11101001100010001111
11101101101010000101
11111010101100011111
11110101101101101011
10101001000100001111
11001101110110011011
10100111111111011101
11111111011001111101
11011000011010101111
11000100000110010111
11001101101100011111
11010101001110011001
10100101010111011001
11000010010011111101
11010100110101111111
10000001000111111001
11111111111111111111
